An awesome list is a list of awesome things curated by the community.
awesome:        😎 Awesome lists about all kinds of interesting topics
awesome-python:        A curated list of awesome Python frameworks, libraries, software and resources
awesome-go:        A curated list of awesome Go frameworks, libraries and software
awesome-selfhosted:        A list of Free Software network services and web applications which can be hosted locally. Selfhosting is the process of hosting and managing applications instead of renting from Software-as-a-Service providers
papers-we-love:        Papers from the computer science community to read and discuss.
awesome-mac:         Now we have become very big, Different from the original idea. Collect premium software in various categories.
awesome-android-ui:        A curated list of awesome Android UI/UX libraries
Awesome-Hacking:        A collection of various awesome lists for hackers, pentesters and security researchers
awesome-nodejs:        ⚡ Delightful Node.js packages and resources
awesome-ios:        A curated list of awesome iOS ecosystem, including Objective-C and Swift Projects
awesome-interview-questions:        A curated awesome list of lists of interview questions. Feel free to contribute! 🎓
awesome-courses:        📚 List of awesome university courses for learning Computer Science!
the-book-of-secret-knowledge:        A collection of inspiring lists, manuals, cheatsheets, blogs, hacks, one-liners, cli/web tools and more.
HelloGitHub:        Find pearls on open-source seashore 分享 GitHub 上有趣、入门级的开源项目
github-cheat-sheet:        A list of cool features of Git and GitHub.
awesome-flutter:        An awesome list that curates the best Flutter libraries, tools, tutorials, articles and more.
frontend-dev-bookmarks:        Manually curated collection of resources for frontend web developers.
awesome-scalability:        The Patterns of Scalable, Reliable, and Performant Large-Scale Systems
awesome-cpp:        A curated list of awesome C++ (or C) frameworks, libraries, resources, and shiny things. Inspired by awesome-... stuff.
awesome-java:        A curated list of awesome frameworks, libraries and software for the Java programming language.
open-source-ios-apps:        📱 Collaborative List of Open-Source iOS Apps
awesome-php:        A curated list of amazingly awesome PHP libraries, resources and shiny things.
awesome-macos-command-line:        Use your macOS terminal shell to do awesome things.
awesome-react-components:        Curated List of React Components & Libraries.
open-source-mac-os-apps:        🚀 Awesome list of open source applications for macOS.
awesome-for-beginners:        A list of awesome beginners-friendly projects.
awesome-electron:        Useful resources for creating apps with Electron
Awesome-Design-Tools:        The best design tools and plugins for everything 👉
awesome-shell:        A curated list of awesome command-line frameworks, toolkits, guides and gizmos. Inspired by awesome-php.
awesome-swift:        A collaborative list of awesome Swift libraries and resources. Feel free to contribute!
awesome-remote-job:        A curated list of awesome remote jobs and resources. Inspired by https://github.com/vinta/awesome-python
awesome-docker:        🐳 A curated list of Docker resources and projects
awesome-vscode:        🎨 A curated list of delightful VS Code packages and resources.
my-mac-os:        List of applications and tools that make my macOS experience even more amazing
awesome-rust:        A curated list of Rust code and resources.
awesome-deep-learning:        A curated list of awesome Deep Learning tutorials, projects and communities.
css-protips:        A collection of tips to help take your CSS skills pro
SpaceVim:        A community-driven modular vim distribution - The ultimate vim configuration
Awesome:        💻 🎉 An awesome & curated list of best applications and tools for Windows.
HarmonyOS:        A curated list of awesome things related to HarmonyOS. 华为鸿蒙操作系统。
awesome-spider:        爬虫集合
Qix:        Machine Learning、Deep Learning、PostgreSQL、Distributed System、Node.Js、Golang
go-patterns:        Curated list of Go design patterns, recipes and idioms
awesome-dotnet-core:        🐝 A collection of awesome .NET core libraries, tools, frameworks and software
awesome-pentest:        A collection of awesome penetration testing resources, tools and other shiny things
awesome-design:        🌟Curated design resources
awesome-falsehood:        😱 Falsehoods Programmers Believe in
awesome-redux:        Awesome list of Redux examples and middlewares
awesome-graphql:        Awesome list of GraphQL & Relay
awesome-dotnet:        A collection of awesome .NET libraries, tools, frameworks and software
spellbook-of-modern-webdev:        A Big Picture, Thesaurus, and Taxonomy of Modern JavaScript Web Development
htaccess:        ✂A collection of useful .htaccess snippets.
awesome-design-systems:        💅🏻 ⚒ A collection of awesome design systems
Awesome-CV:        📄 Awesome CV is LaTeX template for your outstanding job application
awesome-macOS:         A curated list of awesome applications, softwares, tools and shiny things for macOS.
awesome-ruby:        💎 A collection of awesome Ruby libraries, tools, frameworks and software
awesome-design-patterns:        A curated list of software and architecture related design patterns.
vim-galore:        🎓 All things Vim!
awesome-sysadmin:        A curated list of amazingly awesome open source sysadmin resources.
awesome-nlp:        📖 A curated list of resources dedicated to Natural Language Processing (NLP)
Machine-Learning-Tutorials:        machine learning and deep learning tutorials, articles and other resources
Awesome-pytorch-list:        A comprehensive list of pytorch related content on github,such as different models,implementations,helper libraries,tutorials etc.
awesome-actions:        A curated list of awesome actions to use on GitHub
awesome-podcasts:        Collection of awesome podcasts
weekly:        前端精读周刊
terminals-are-sexy:        💥 A curated list of Terminal frameworks, plugins & resources for CLI lovers.
awesome-laravel:        A curated list of bookmarks, packages, tutorials, videos and other cool resources from the Laravel ecosystem
awesome-hyper:        🖥 Delightful Hyper plugins, themes, and resources
awesome-stock-resources:        🌇 A collection of links for free stock photography, video and Illustration websites
awesome-microservices:        A curated list of Microservice Architecture related principles and technologies.
awesome-bigdata:        A curated list of awesome big data frameworks, ressources and other awesomeness.
awesome-flask:        A curated list of awesome Flask resources and plugins
SwifterSwift:        A handy collection of more than 500 native Swift extensions to boost your productivity.
GitHub-Dark:        Dark GitHub style
be-a-professional-programmer:        成为专业程序员路上用到的各种优秀资料、神器及框架
Android_Data:        Some Android learning materials, hoping to help you learn Android development.
movies-for-hackers:        🎬 A curated list of movies every hacker & cyberpunk must watch.
GoBooks:        List of Golang books
awesome-zsh-plugins:        A collection of ZSH frameworks, plugins, themes and tutorials.
awesome-android:        A curated list of awesome Android packages and resources.
awesome-scala:        A community driven list of useful Scala libraries, frameworks and software.
awesomo:        An extensive list of cool open source projects written in С, C++, Clojure, Lisp, Elixir, Erlang, Elm, Golang, Haskell, JavaScript, Lua, OCaml, Python, R, Ruby, Rust, Scala etc.
awesome-angular:        📄 A curated list of awesome Angular resources
magictools:        🎮 📝 A list of Game Development resources to make magic happen.
Android-Debug-Database:        A library for debugging android databases and shared preferences - Make Debugging Great Again
golang-open-source-projects:        为互联网IT人打造的中文版awesome-go
52-technologies-in-2016:        Let's learn a new technology every week. A new technology blog every Sunday in 2016.
awesome-raspberry-pi:        📝 A curated list of awesome Raspberry Pi tools, projects, images and resources
Awesome_APIs:        A collection of APIs
awesome-readme:        A curated list of awesome READMEs