Chrome is a web browser from the tech company Google.
electron:        Build cross-platform desktop apps with JavaScript, HTML, and CSS
mkcert:        A simple zero-config tool to make locally trusted development certificates with any names you'd like.
octotree:        GitHub on steroids
nightmare:        A high-level browser automation library.
chromeless:        ğŸ–¥ Chrome automation made simple. Runs locally or headless on AWS Lambda.
linux-command:        Linuxå‘½ä»¤å¤§å…¨æœç´¢å·¥å…·ï¼Œå†…å®¹åŒ…å«Linuxå‘½ä»¤æ‰‹å†Œã€è¯¦è§£ã€å­¦ä¹ ã€æœé›†ã€‚https://git.io/linux
WebFundamentals:        Best practices for modern web development
react-color:        ğŸ¨ Color Pickers from Sketch, Photoshop, Chrome, Github, Twitter & more
uBlock:        uBlock: a fast, lightweight, and lean blocker for Chrome, Firefox, and Safari.
google-access-helper:        è°·æ­Œè®¿é—®åŠ©æ‰‹ç ´è§£ç‰ˆ
puppeteer-recorder:        Puppeteer recorder is a Chrome extension that records your browser interactions and generates a Puppeteer script.
bypass-paywalls-chrome:        Bypass Paywalls web browser extension for Chrome and Firefox.
url-to-pdf-api:        Web page PDF/PNG rendering done right. Self-hosted service for rendering receipts, invoices, or any content.
ext-saladict:        Feature-rich professional inline translator.
chromedp:        A faster, simpler way to drive browsers supporting the Chrome DevTools Protocol.
headless-chrome-crawler:        Distributed crawler powered by Headless Chrome
debugger:        The faster and smarter Debugger for Firefox DevTools ğŸ”¥ğŸ¦ŠğŸ› 
ferret:        Declarative web scraping
fetool:        å¤§å‰ç«¯çš„ç‘å£«å†›åˆ€ï¼Œåªè®°å½•æœ‰ç”¨çš„ã€‚
polar-bookshelf:        Polar is a personal knowledge repository for PDF and web content supporting incremental reading and document annotation.
simpread:        ç®€æ‚¦ ( SimpRead ) - è®©ä½ ç¬é—´è¿›å…¥æ²‰æµ¸å¼é˜…è¯»çš„æ‰©å±•
metamask-extension:        ğŸŒ ğŸ”Œ The MetaMask browser extension enables browsing Ethereum blockchain enabled websites
themer:        ğŸ¨ themer takes a set of colors and generates themes for your apps (editors, terminals, wallpapers, and more).
melonJS:        a fresh & lightweight javascript game engine
Surfingkeys:        Map your keys for web surfing, expand your browser with javascript and keyboard.
crx-selection-translate:        è®©æµè§ˆä»»æ„è¯­è¨€çš„ç½‘ç«™å˜å¾—æ— æ¯”è½»æ¾çš„æµè§ˆå™¨æ‰©å±•ç¨‹åºã€‚
YouTubeCenter:        YouTube Center is a userscript designed to expand the functionality of YouTube. It includes the ability to download the video you're watching, auto selecting your preferred video quality and much more.
clockwork:        Clockwork - php dev tools in your browser - server-side component
jest-puppeteer:        Run your tests using Jest & Puppeteer ğŸªâœ¨
AndroidChromium:        chrome browser of android version from chromium open project
body-scroll-lock:        Body scroll locking that just works with everything ğŸ˜
React-Sight:        Visualization tool for React, with support for Fiber, Router (v4), and Redux
serverless-chrome:        ğŸŒ Run headless Chrome/Chromium on AWS Lambda
the-front-end-knowledge-you-may-not-know:        ğŸ˜‡ ä½ å¯èƒ½ä¸çŸ¥é“çš„å‰ç«¯çŸ¥è¯†ç‚¹
SingleFile:        Web Extension for Firefox/Chrome/Edge and CLI tool to save a faithful copy of an entire web page in a single HTML file
cefpython:        Python bindings for the Chromium Embedded Framework (CEF)
chromium-vim:        Vim bindings for Google Chrome.
json-viewer:        It is a Chrome extension for printing JSON and JSONP.
selenium-python-helium:        Selenium-python but lighter: Helium is the best Python library for web automation.
vscode-chrome-debug:        Debug your JavaScript code running in Google Chrome from VS Code.
badssl.com:        ğŸ”’ Memorable site for testing clients against bad SSL configs.
browser:        The browser extension vault (Chrome, Firefox, Opera, Edge, Safari, & more).
ReplaceGoogleCDN:        â™‹ ä¸€ä¸ª Chrome æ’ä»¶ï¼šå°† Google CDN æ›¿æ¢ä¸ºå›½å†…çš„ã€‚
phpdesktop:        Develop desktop GUI applications using PHP, HTML5, JavaScript and SQLite
notes:        ğŸ“” Linuxã€MySQLã€Nginxã€PHPã€Gitã€Shell ç­‰ç¬”è®°
blog:        æµ©éºŸçš„æŠ€æœ¯åšå®¢
asar:        Simple extensive tar-like archive format with indexing
Front-end-tutorial:        ğŸ¼ æœ€å…¨çš„èµ„æºæ•™ç¨‹-å‰ç«¯æ¶‰åŠçš„æ‰€æœ‰çŸ¥è¯†ä½“ç³»ï¼Œå¹¶åœ¨ Nice Front-end Tutorial æŒç»­æ›´æ–°ï¼›
puppeteer-extra:        ğŸ’¯ Teach puppeteer new tricks through plugins.
floccus:        â˜ï¸ Sync your bookmarks across browsers via Nextcloud, WebDAV or a local file (and thus any file sync solution)
lightproxy:        ğŸ’ Cross platform Web debugging proxy
puppeteer-sharp:        Headless Chrome .NET API
docker-selenium:        Selenium in Docker with Chrome & Firefox plus video recording support. Also check: Zalenium
lightcrawler:        Crawl a website and run it through Google lighthouse
t-rex-runner:        the t-rex runner game extracted from chromium
marinara:        PomodoroÂ® time management assistant for Chrome
puppeteer-webperf:        Automating Web Performance testing with Puppeteer ğŸª
cxmooc-tools:        ä¸€ä¸ª è¶…æ˜Ÿ(å­¦ä¹ é€š)/æ™ºæ…§æ ‘(çŸ¥åˆ°)/ä¸­å›½å¤§å­¦æ…•è¯¾ åˆ·è¯¾å·¥å…·,ç«ç‹,è°·æ­Œ,æ²¹çŒ´æ”¯æŒ.å…¨è‡ªåŠ¨ä»»åŠ¡,è§†é¢‘å€é€Ÿç§’è¿‡,ä½œä¸šè€ƒè¯•é¢˜åº“,éªŒè¯ç è‡ªåŠ¨æ‰“ç (à©§á›à©­æŒ‚ç§‘æ¨¡å¼,å¯åŠ¨)
xdm:        Powerfull download accelerator and video downloader
ChromeLikeTabSwitcher:        Provides a tab switcher similar to the one, which is used in Google Chrome on Android
WeiboPicBed:        æ–°æµªå¾®åšå›¾åºŠ Chromeæ‰©å±•
browserpass-legacy:        Legacy Browserpass repo, development is now happening at:
Indium:        A JavaScript development environment for Emacs
Userscript-Plus:        ğŸ’ Show current site all UserJSï¼ŒThe easier way to install UserJs for Tampermonkey. æ˜¾ç¤ºå½“å‰ç½‘ç«™çš„æ‰€æœ‰å¯ç”¨Tampermonkeyè„šæœ¬
github-awesome-autocomplete:        Add instant search capabilities to GitHub's search bar
GayHub:        An awesome chrome extension for github
vialer-js:        Pluggable WebRTC softphone and communication platform.
puppeteer-deep:        Puppeteer, Headless Chromeï¼›çˆ¬å–ã€Šes6æ ‡å‡†å…¥é—¨ã€‹ã€è‡ªåŠ¨æ¨æ–‡åˆ°æ˜é‡‘ã€ç«™ç‚¹æ€§èƒ½åˆ†æï¼›é«˜çº§çˆ¬è™«ã€è‡ªåŠ¨åŒ–UIæµ‹è¯•ã€æ€§èƒ½åˆ†æï¼›
navalia:        A bullet-proof, fast, and reliable headless browser API
atomic-chrome:        Edit Chrome textareas in Atom
ember-inspector:        Adds an Ember tab to the browser's Developer Tools that allows you to inspect Ember objects in your application.
DuckieTV:        A web application built with AngularJS to track your favorite tv-shows with semi-automagic torrent integration
chromelogger:        chrome extension for server side console logging
v8-bailout-reasons:        ğŸ”§ A list of Crankshaft bailout reasons with examples
better-onetab:        ğŸ“‘ A better OneTab for Chrome (Temporarily removed from firefox & without maintain in a period & any cooperative purpose are welcome)
Cookie-AutoDelete:        Firefox and Chrome WebExtension/Addon that deletes cookies as soon as the tab closes, domain changes, browser restarts, or a combination of those events.
ferrum:        Headless Chrome Ruby API
TileIconifier:        Creates tiles for most Windows 8.1 and 10 start menu icons
toggl-button:        Toggl Button extension for Chrome and Firefox
AdguardBrowserExtension:        AdGuard browser extension
gooreplacer:        âš¡ï¸âš¡ï¸A browser extension to modify HTTP requests :-)
gowitness:        ğŸ” gowitness - a golang, web screenshot utility using Chrome Headless
elevate:        Browser extension for strava. "Elevate" tracks your fitness and progressions over time. Analyse deeper your activities & segments. And more... https://thomaschampagne.github.io/elevate/ (formerly named stravistix)
demo-progressive-web-app:        ğŸ‰ A demo for progressive web application with features like offline, push notifications, background sync etc,
TimeCat:        A Magical Web Recorder ğŸ–¥ (WIP)
cef2go:        Go lang bindings for the Chromium Embedded Framework (CEF)
SponsorBlock:        Skip YouTube video sponsors (browser extension)
jocs.github.io:        ğŸ’¯Jocs çš„ä¸ªäººåšå®¢ï¼Œæ‰€æœ‰çš„æ–‡ç« éƒ½åœ¨ issues é‡Œé¢
web-extension-starter:        ğŸ–¥ğŸ”‹Web Extension starter to build "Write Once Run on Any Browser" extension
markdown-new-tab:        ğŸ—’ï¸ â° âœ… Save notes in Markdown directly in the 'New Tab' page