Docker is a platform built for developers to build and run applications.
moby:        Moby Project - a collaborative project for the container ecosystem to assemble container-based systems
netdata:        Real-time performance monitoring, done right! https://www.netdata.cloud
mall:        mallé¡¹ç›®æ˜¯ä¸€å¥—ç”µå•†ç³»ç»Ÿï¼ŒåŒ…æ‹¬å‰å°å•†åŸç³»ç»ŸåŠåå°ç®¡ç†ç³»ç»Ÿï¼ŒåŸºäºSpringBoot+MyBatiså®ç°ï¼Œé‡‡ç”¨Dockerå®¹å™¨åŒ–éƒ¨ç½²ã€‚ å‰å°å•†åŸç³»ç»ŸåŒ…å«é¦–é¡µé—¨æˆ·ã€å•†å“æ¨èã€å•†å“æœç´¢ã€å•†å“å±•ç¤ºã€è´­ç‰©è½¦ã€è®¢å•æµç¨‹ã€ä¼šå‘˜ä¸­å¿ƒã€å®¢æˆ·æœåŠ¡ã€å¸®åŠ©ä¸­å¿ƒç­‰æ¨¡å—ã€‚ åå°ç®¡ç†ç³»ç»ŸåŒ…å«å•†å“ç®¡ç†ã€è®¢å•ç®¡ç†ã€ä¼šå‘˜ç®¡ç†ã€ä¿ƒé”€ç®¡ç†ã€è¿è¥ç®¡ç†ã€å†…å®¹ç®¡ç†ã€ç»Ÿè®¡æŠ¥è¡¨ã€è´¢åŠ¡ç®¡ç†ã€æƒé™ç®¡ç†ã€è®¾ç½®ç­‰æ¨¡å—ã€‚
traefik:        The Cloud Native Edge Router
kong:        ğŸ¦ The Cloud-Native API Gateway
spring-boot-examples:        about learning Spring Boot via examples. Spring Boot æ•™ç¨‹ã€æŠ€æœ¯æ ˆç¤ºä¾‹ä»£ç ï¼Œå¿«é€Ÿç®€å•ä¸Šæ‰‹æ•™ç¨‹ã€‚
mastodon:        Your self-hosted, globally interconnected microblogging community
drone:        Drone is a Container-Native, Continuous Delivery Platform
dive:        A tool for exploring each layer in a docker image
compose:        Define and run multi-container applications with Docker
docker-cheat-sheet:        Docker Cheat Sheet
awesome-docker:        ğŸ³ A curated list of Docker resources and projects
faas:        OpenFaaS - Serverless Functions Made Simple
docker_practice:        Learn and understand Docker technologies, with real DevOps practice!
generator-jhipster:        JHipster is a development platform to quickly generate, develop, & deploy modern web applications & microservice architectures.
portainer:        Making Docker management easy.
rancher:        Complete container management platform
eShopOnContainers:        Cross-platform .NET sample microservices and container based application that runs on Linux Windows and macOS. Powered by .NET Core 3.0, Docker Containers and Azure Kubernetes Services. Supports Visual Studio, VS for Mac and CLI based environments with Docker CLI, dotnet CLI, VS Code or any other code editor.
nginx-proxy:        Automated nginx proxy for Docker containers using docker-gen
awesome-cheatsheets:        ğŸ‘©â€ğŸ’»ğŸ‘¨â€ğŸ’» Awesome cheatsheets for popular programming languages, frameworks and development tools. They include everything you should know in one single file.
kitematic:        Visual Docker Container Management on Mac & Windows
nvidia-docker:        Build and run Docker containers leveraging NVIDIA GPUs
reaction:        Reaction is an API-first, headless commerce platform built using Node.js, React, GraphQL. Deployed via Docker and Kubernetes.
ctop:        Top-like interface for container metrics
awesome-kubernetes:        A curated list for awesome kubernetes sources ğŸš¢ğŸ‰
gvisor:        Application Kernel for Containers
dockerfiles:        Various Dockerfiles I use on the desktop and on servers.
verdaccio:        ğŸ“¦ğŸ”A lightweight private npm proxy registry
skaffold:        Easy and Repeatable Kubernetes Development
transfer.sh:        Easy and fast file sharing from the command-line.
laradock:        Full PHP development environment for Docker.
docker-elk:        The Elastic stack (ELK) powered by Docker and Compose.
jib:        ğŸ— Build container images for your Java applications.
labs:        This is a collection of tutorials for learning how to use Docker with various tools. Contributions welcome.
piggymetrics:        Microservice Architecture with Spring Boot, Spring Cloud and Docker
hydra:        OAuth2 Server and OpenID Certifiedâ„¢ OpenID Connect Provider written in Go - cloud native, security-first, open source API security for your infrastructure. SDKs for any language.
docker-slim:        DockerSlim (docker-slim): Don't change anything in your Docker container image and minify it by up to 30x (and for compiled languages even more) making it secure too! (free and open source)
n8n:        Free and open fair-code licensed node based Workflow Automation Tool. Easily automate tasks across different services.
paperwork:        Paperwork - OpenSource note-taking & archiving alternative to Evernote, Microsoft OneNote & Google Keep
distroless:        ğŸ¥‘ Language focused docker images, minus the operating system.
rook:        Storage Orchestration for Kubernetes
mal:        mal - Make a Lisp
runc:        CLI tool for spawning and running containers according to the OCI specification
mlcourse.ai:        Open Machine Learning Course
clair:        Vulnerability Static Analysis for Containers
crawlab:        Distributed web crawler admin platform for spiders management regardless of languages and frameworks. åˆ†å¸ƒå¼çˆ¬è™«ç®¡ç†å¹³å°ï¼Œæ”¯æŒä»»ä½•è¯­è¨€å’Œæ¡†æ¶
docker-gitlab:        Dockerized GitLab
SpaceX-API:        ğŸš€ Open Source REST API for rocket, core, capsule, pad, and launch data
fabio:        Consul Load-Balancing made simple
openebs:        Leading Open Source Container Attached Storage, built using Cloud Native Architecture, simplifies running Stateful Applications on Kubernetes.
vulhub:        Pre-Built Vulnerable Environments Based on Docker-Compose
che:        Eclipse Che: Next-generation Eclipse IDE. Open source workspace server and cloud IDE.
watchtower:        A process for automating Docker container base image updates.
goreleaser:        Deliver Go binaries as fast and easily as possible
weave:        Simple, resilient multi-host containers networking and more.
kind:        Kubernetes IN Docker - local clusters for testing Kubernetes
caprover:        [previously CaptainDuckDuck] Automated Scalable PaaS Package (automated Docker+nginx) - Heroku on Steroids
mall-learning:        mallå­¦ä¹ æ•™ç¨‹ï¼Œæ¶æ„ã€ä¸šåŠ¡ã€æŠ€æœ¯è¦ç‚¹å…¨æ–¹ä½è§£æã€‚mallé¡¹ç›®ï¼ˆ25k+starï¼‰æ˜¯ä¸€å¥—ç”µå•†ç³»ç»Ÿï¼Œä½¿ç”¨ç°é˜¶æ®µä¸»æµæŠ€æœ¯å®ç°ã€‚ æ¶µç›–äº†SpringBoot2.1.3ã€MyBatis3.4.6ã€Elasticsearch6.2.2ã€RabbitMQ3.7.15ã€Redis5.0ã€Mongodb4.2.5ã€Mysql5.7ç­‰æŠ€æœ¯ï¼Œé‡‡ç”¨Dockerå®¹å™¨åŒ–éƒ¨ç½²ã€‚
containerd:        An open and reliable container runtime
server:        The core infrastructure backend (API, database, Docker, etc).
docker-openvpn:        ğŸ”’ OpenVPN server in a Docker container complete with an EasyRSA PKI CA
docker-node:        Official Docker Image for Node.js ğŸ³ ğŸ¢ ğŸš€
docker-mailserver:        A fullstack but simple mailserver (smtp, imap, antispam, antivirus, ssl...) using Docker.
devops-exercises:        Linux, Jenkins, AWS, SRE, Prometheus, Docker, Python, Ansible, Git, Kubernetes, Terraform, OpenStack, SQL, NoSQL, Azure, GCP, DNS, Elastic, Network, Virtualization
socketcluster:        Highly scalable realtime framework
follow-me-install-kubernetes-cluster:        å’Œæˆ‘ä¸€æ­¥æ­¥éƒ¨ç½² kubernetes é›†ç¾¤
kubeasz:        ä½¿ç”¨Ansibleè„šæœ¬å®‰è£…K8Sé›†ç¾¤ï¼Œä»‹ç»ç»„ä»¶äº¤äº’åŸç†ï¼Œæ–¹ä¾¿ç›´æ¥ï¼Œä¸å—å›½å†…ç½‘ç»œç¯å¢ƒå½±å“
flannel:        flannel is a network fabric for containers, designed for Kubernetes
kuboard-press:        Kuboard æ˜¯åŸºäº Kubernetes çš„å¾®æœåŠ¡ç®¡ç†ç•Œé¢ã€‚åŒæ—¶æä¾› Kubernetes å…è´¹ä¸­æ–‡æ•™ç¨‹ï¼Œå…¥é—¨æ•™ç¨‹ï¼Œæœ€æ–°ç‰ˆæœ¬çš„ Kubernetes v1.18 å®‰è£…æ‰‹å†Œï¼Œ(k8s install) åœ¨çº¿ç­”ç–‘ï¼ŒæŒç»­æ›´æ–°ã€‚
kompose:        Go from Docker Compose to Kubernetes
docker-letsencrypt-nginx-proxy-companion:        LetsEncrypt companion container for nginx-proxy
docker-stacks:        Ready-to-run Docker images containing Jupyter applications
docker-gc:        INACTIVE: Docker garbage collection of containers and images
aws-sam-cli:        CLI tool to build, test, debug, and deploy Serverless applications using AWS SAM
elasticsearch-dump:        Import and export tools for elasticsearch
openwhisk:        Apache OpenWhisk is an open source serverless cloud platform
node-express-mongoose-demo:        A simple demo app using node and mongodb for beginners
docker-py:        A Python library for the Docker Engine API
firefly-iii:        Firefly III: a personal finances manager
fn:        The container native, cloud agnostic serverless platform.
tini:        A tiny but valid `init` for containers
docker-ce:        Docker CE
dumb-init:        A minimal init system for Linux containers
pachyderm:        Reproducible Data Science at Scale!
GuiLite:        âœ”ï¸The smallest header-only GUI library(5 KLOC) for all platforms
scope:        Monitoring, visualisation & management for Docker & Kubernetes
registrator:        Service registry bridge for Docker with pluggable adapters
chatwoot:        Open-source live chat software ğŸ”¥ğŸ’¬
trivy:        A Simple and Comprehensive Vulnerability Scanner for Containers, Suitable for CI
docker-selenium:        Docker images for Selenium Grid Server (Standalone, Hub, and Nodes).