Git is the most widely used version control system.
gitignore:        A collection of useful .gitignore templates
gogs:        Gogs is a painless self-hosted Git service
bat:        A cat(1) clone with wings.
gitea:        Git with a cup of tea, painless self-hosted git service
hub:        A command-line tool that makes git easier to use with GitHub.
husky:        Git hooks made easy ğŸ¶ woof!
lazygit:        simple terminal UI for git commands
tips:        Most commonly used git tips and tricks.
git-extras:        GIT utilities -- repo summary, repl, changelog population, author commit percentages and more
diff-so-fancy:        Good-lookin' diffs. Actuallyâ€¦ nahâ€¦ The best-lookin' diffs. ğŸ‰
git-recipes:        ğŸ¥¡ Git recipes in Chinese by Zhongyi Tong. é«˜è´¨é‡çš„Gitä¸­æ–‡æ•™ç¨‹.
netlify-cms:        A Git-based CMS for Static Site Generators
git-history:        Quickly browse the history of a file from any git repository
git-tips:        Gitçš„å¥‡æŠ€æ·«å·§
phabricator:        Open software engineering platform and fun adventure game
bit:        Build, distribute and collaborate on components.
technology-talk:        æ±‡æ€»javaç”Ÿæ€åœˆå¸¸ç”¨æŠ€æœ¯æ¡†æ¶ã€å¼€æºä¸­é—´ä»¶ï¼Œç³»ç»Ÿæ¶æ„ã€æ•°æ®åº“ã€å¤§å…¬å¸æ¶æ„æ¡ˆä¾‹ã€å¸¸ç”¨ä¸‰æ–¹ç±»åº“ã€é¡¹ç›®ç®¡ç†ã€çº¿ä¸Šé—®é¢˜æ’æŸ¥ã€ä¸ªäººæˆé•¿ã€æ€è€ƒç­‰çŸ¥è¯†
cli:        GitHubâ€™s official command line tool
walle-web:        walle - ç“¦åŠ› Devopså¼€æºé¡¹ç›®ä»£ç éƒ¨ç½²å¹³å°
desktop:        Simple collaboration from your desktop
cz-cli:        The commitizen command line utility. #BlackLivesMatter
tig:        Text-mode interface for git
pure:        Pretty, minimal and fast ZSH prompt
ungit:        The easiest way to use git. On any platform. Anywhere.
git-lfs:        Git extension for versioning large files
gitbucket:        A Git platform powered by Scala with easy installation, high extensibility & GitHub API compatibility
wiki:        Wiki.js | A modern, lightweight and powerful wiki app built on Node.js
libgit2:        A cross-platform, linkable library implementation of Git that you can use in your application.
w3-goto-world:        ğŸ…Git Mirrorã€AWS hostã€FREE SS/SSR/VMESSã€WireGuardã€IPFSã€DeepWebã€Social Topicç­‰çŸ¥è¯†å‚¨å¤‡åº“
lint-staged:        ğŸš«ğŸ’© â€” Run linters on git staged files
gitsome:        A supercharged Git/GitHub command line interface (CLI). An official integration for GitHub and GitHub Enterprise: https://github.com/works-with/category/desktop-tools
my-git:        Individual collecting material of learning gitï¼ˆæœ‰å…³ git çš„å­¦ä¹ èµ„æ–™ï¼‰
git-standup:        Recall what you did on the last working day. Psst! or be nosy and find what someone else in your team did ;-)
bfg-repo-cleaner:        Removes large or troublesome blobs like git-filter-branch does, but faster. And written in Scala
docker-gitlab:        Dockerized GitLab
vim-gitgutter:        A Vim plugin which shows git diff markers in the sign column and stages/previews/undoes hunks and partial hunks.
githug:        Git your game on!
sourcerer-app:        ğŸ¦„ Sourcerer app makes a visual profile from your GitHub and git repositories.
gitleaks:        Scan git repos for secrets using regex and entropy ğŸ”‘
commitlint:        ğŸ““ Lint commit messages
dvc:        ğŸ¦‰Data Version Control | Git for Data & Models
devops-exercises:        Linux, Jenkins, AWS, SRE, Prometheus, Docker, Python, Ansible, Git, Kubernetes, Terraform, OpenStack, SQL, NoSQL, Azure, GCP, DNS, Elastic, Network, Virtualization
legit:        Git for Humans, Inspired by GitHub for Macâ„¢.
gitql:        ğŸ’Š A git query language
translations:        ğŸ¼ Chinese translations for classic IT resources
gitpitch:        Markdown Presentations for Tech Conferences, Training, Developer Advocates, and Educators.
dev-setup:        macOS development environment setup: Easy-to-understand instructions with automated setup scripts for developer tools like Vim, Sublime Text, Bash, iTerm, Python data analysis, Spark, Hadoop MapReduce, AWS, Heroku, JavaScript web development, Android development, common data stores, and dev-based OS X defaults.
gitextensions:        Git Extensions is a standalone UI tool for managing git repositories. It also integrates with Windows Explorer and Microsoft Visual Studio (2015/2017/2019).
go-git:        Projects has been moved to:
git-ftp:        Uses Git to upload only changed files to FTP servers.
vscode-gitlens:        Supercharge the Git capabilities built into Visual Studio Code â€” Visualize code authorship at a glance via Git blame annotations and code lens, seamlessly navigate and explore Git repositories, gain valuable insights via powerful comparison commands, and so much more
git-style-guide:        A Git Style Guide
git-bug:        Distributed, offline-first bug tracker embedded in git, with bridges
pre-commit:        A framework for managing and maintaining multi-language pre-commit hooks.
nodegit:        Native Node bindings to Git.
conventional-changelog:        Generate changelogs and release notes from a project's commit messages and metadata.
magit:        It's Magit! A Git porcelain inside Emacs.
posh-git:        A PowerShell environment for Git
docker-ce:        Docker CE
SparkleShare:        Share and collaborate by syncing with any Git repository instantly. Linux, macOS, and Windows.
gitflow-avh:        AVH Edition of the git extensions to provide high-level repository operations for Vincent Driessen's branching model
lolcommits:        ğŸ“· git-based selfies for software developers
keep-a-changelog:        If you build software, keep a changelog.
FAQGURU:        ğŸ’ ğŸš€ ğŸ‰ A list of interview questions. This repository is everything you need to prepare for your technical interview.
standard-version:        ğŸ† Automate versioning and CHANGELOG generation, with semver.org and conventionalcommits.org
git-quick-stats:        â–â–…â–†â–ƒâ–… Git quick statistics is a simple and efficient way to access various statistics in git repository.
delta:        A viewer for git and diff output
progit2:        Pro Git 2nd Edition
grv:        GRV is a terminal interface for viewing git repositories
gopass:        The slightly more awesome standard unix password manager for teams
Waking-Up:        è®¡ç®—æœºåŸºç¡€ï¼ˆè®¡ç®—æœºç½‘ç»œ/æ“ä½œç³»ç»Ÿ/æ•°æ®åº“/Git...ï¼‰é¢è¯•é—®é¢˜å…¨é¢æ€»ç»“ï¼ŒåŒ…å«è¯¦ç»†çš„follow-up questionä»¥åŠç­”æ¡ˆï¼›å…¨éƒ¨é‡‡ç”¨ã€é—®é¢˜+è¿½é—®+ç­”æ¡ˆã€‘çš„å½¢å¼ï¼Œå³æ‹¿å³ç”¨ï¼Œç›´å‡»äº’è”ç½‘å¤§å‚é¢è¯•ğŸš€ï¼›å¯ç”¨äºæ¨¡æ‹Ÿé¢è¯•ã€é¢è¯•å‰å¤ä¹ ã€çŸ­æœŸå†…å¿«é€Ÿå¤‡æˆ˜é¢è¯•...
release-it:        ğŸš€ Automate versioning and package publishing
gitkube:        Build and deploy docker images to Kubernetes using git push
onedev:        Super Easy All-In-One DevOps Platform
git-fire:        ğŸ”¥ Save Your Code in an Emergency
awesome-blockchains:        A collection about awesome blockchains - open distributed public databases w/ crypto hashes incl. git ;-). Blockchains are the new tulips ğŸŒ·ğŸŒ·ğŸŒ·. Distributed is the new centralized.
DevOps-Guide:        DevOps Guide from basic to advanced with Interview Questions and Notes ğŸ”¥
awesome-programming-books:        ğŸ“š ç»å…¸æŠ€æœ¯ä¹¦ç±æ¨èï¼ŒæŒç»­æ›´æ–°...
git-cheat-sheet:        git and git flow cheat sheet
gitlist:        An elegant and modern git repository viewer
joe:        ğŸƒ A .gitignore magician in your command line
training-kit:        Open source cheat sheets for Git and GitHub
Git-Credential-Manager-for-Windows:        Secure Git credential storage for Windows with support for Visual Studio Team Services, GitHub, and Bitbucket multi-factor authentication.
git-sketch-plugin:        ğŸ’ A Git client generating pretty diffs built right into Sketch.
versionpress:        Git-based version control for WordPress. Whoa!
picocli:        Picocli is a modern framework for building powerful, user-friendly, GraalVM-enabled command line apps with ease. It supports colors, autocompletion, subcommands, and more. In 1 source file so apps can include as source & avoid adding a dependency. Written in Java, usable from Groovy, Kotlin, Scala, etc.
git-open:        Type `git open` to open the GitHub page or website for a repository in your browser.
libgit2sharp:        Git + .NET/Mono = â¤
git-recall:        An interactive way to peruse your git history from the terminal
conventionalcommits.org:        The conventional commits specification