Gradle is an open-source build tool that helps teams build, automate and deliver better software, faster.
gradle:        Adaptable, fast automation for all
jib:        ğŸ— Build container images for your Java applications.
AndroidDevTools:        æ”¶é›†æ•´ç†Androidå¼€å‘æ‰€éœ€çš„Android SDKã€å¼€å‘ä¸­ç”¨åˆ°çš„å·¥å…·ã€Androidå¼€å‘æ•™ç¨‹ã€Androidè®¾è®¡è§„èŒƒï¼Œå…è´¹çš„è®¾è®¡ç´ æç­‰ã€‚
walle:        Android Signature V2 Schemeç­¾åä¸‹çš„æ–°ä¸€ä»£æ¸ é“åŒ…æ‰“åŒ…ç¥å™¨
packer-ng-plugin:        ä¸‹ä¸€ä»£Androidæ‰“åŒ…å·¥å…·ï¼Œ100ä¸ªæ¸ é“åŒ…åªéœ€è¦10ç§’é’Ÿ
hibernate-orm:        Hibernate's core Object/Relational Mapping functionality
android-tips-tricks:        â˜‘ï¸ [Cheatsheet] Tips and tricks for Android Development
dryrun:        â˜ï¸ Try the demo project of any Android Library
Robust:        Robust is an Android HotFix solution with high compatibility and high stability. Robust can fix bugs immediately without a reboot.
kotlin-dsl-samples:        Samples builds using the Gradle Kotlin DSL
kotlin-examples:        Various examples for Kotlin
T-MVP:        Android AOP Architecture by Apt, AspectJ, Javassisit, based on Realm+Databinding+MVP+Retrofit+Rxjava2
ArgusAPM:        Powerful, comprehensive (Android) application performance management platform. 360çº¿ä¸Šç§»åŠ¨æ€§èƒ½æ£€æµ‹å¹³å°
VasDolly:        Android V1 and V2 Signature Channel Package Plugin
jitpack.io:        Documentation and issues of https://jitpack.io
baritone:        google maps for block game
MaterialSearchBar:        Material Design Search Bar for Android
WorldEdit:        ğŸ—ºï¸ Minecraft map editor and mod
PublicCMS:        ç°ä»£åŒ–java cmsï¼Œè½»æ¾æ”¯æ’‘åƒä¸‡æ•°æ®ã€åƒä¸‡PVï¼›æ”¯æŒé™æ€åŒ–ï¼ŒæœåŠ¡å™¨ç«¯åŒ…å«; ç›®å‰å·²ç»æ‹¥æœ‰å…¨çƒ0.0002%çš„ç”¨æˆ·ï¼Œä¸­å›½æœ¬åœŸæœ‰åŒ—äº¬ä¸¤å¤§åœ°æ ‡(åŒ—æµ·å…¬å›­ã€ä¸­å›½å°Šå¤§å¦)å®˜ç½‘ã€å›½å®¶è´¢æ”¿éƒ¨ã€å¹¿ç”µæ€»å±€ã€å¤®è§†å½±éŸ³åå°ã€æ ¼å…°ä»•ã€å±±è¥¿çœå·¥ä¸šå’Œä¿¡æ¯åŒ–å…ã€æµ™æ±Ÿçœè´¢æ”¿å…ç­‰æ­£åœ¨ä½¿ç”¨ï¼›è¯­è¨€æ”¯æŒä¸­ã€ç¹ã€æ—¥ã€è‹±ï¼›æ˜¯ä¸€ä¸ªå·²èµ°å‘æµ·å¤–çš„æˆç†ŸCMSäº§å“
dns66:        DNS-based Host Blocker (and lightweight ad blocker) for Android
okbuck:        OkBuck is a gradle plugin that lets developers utilize the Buck build system on a gradle project.
fastdex:        ğŸš€ åŠ å¿« apk çš„ç¼–è¯‘é€Ÿåº¦ ğŸš€
spotless:        Keep your code spotless
AnyChart-Android:        AnyChart Android Chart is an amazing data visualization library for easily creating interactive charts in Android apps. It runs on API 19+ (Android 4.4) and features dozens of built-in chart types.
Cipher.so:        A simple way to encrypt your secure data like passwords into a native .so library.
Android-ReadTheFuckingSourceCode:        ğŸ˜œ è®°å½•æ—¥å¸¸çš„å¼€å‘æŠ€å·§ï¼Œå¼€å‘ä¸­é‡åˆ°çš„æŠ€æœ¯é‡ç‚¹ã€éš¾ç‚¹ï¼Œå„ä¸ªçŸ¥è¯†ç‚¹çš„æ€»ç»“ï¼Œä¼˜è´¨é¢è¯•é¢˜ç­‰ç­‰ã€‚æŒç»­æ›´æ–°...
PiracyChecker:        An Android library that prevents your app from being pirated / cracked using Google Play Licensing (LVL), APK signature protection and more. API 14+ required.
materialChipView:        Material Chip view. Can be used as tags for categories, contacts or creating text clouds
MaterialStyledDialogs:        A library that shows a beautiful and customizable Material-based dialog with header. API 14+ required.
S-MVP:        ğŸ”¥ğŸ”¥ä¼˜åŒ–ç‰ˆMVP,ä½¿ç”¨æ³¨è§£æ³›å‹ç®€åŒ–ä»£ç ç¼–å†™ï¼Œä½¿ç”¨æ¨¡å—åŒ–åè®®æ–¹ä¾¿ç»´æŠ¤ï¼ŒAPTè¿‡ç¨‹ä½¿ç”¨æ³¨è§£è§£æå™¨åˆ©ç”¨JavaPoetğŸŒå®Œæˆé‡å¤æ¨¡å—çš„ç¼–å†™ï¼Œåˆ©ç”¨ASpect+GradlePlugin å®Œæˆæ¨ªå‘AOPç¼–ç¨‹+JavassiståŠ¨æ€å­—èŠ‚ç æ³¨å…¥+Tinkerå®ç°çƒ­ä¿®å¤+Retrofitå®ç°ä¼˜é›…ç½‘ç»œæ“ä½œ+RxJavaè½»æ¾ç©è½¬æ•°æ®å¤„ç†
SpongeForge:        A Forge mod that implements SpongeAPI
AndroidAnimationExercise:        Android åŠ¨ç”»å„ç§å®ç°ï¼ŒåŒ…æ‹¬å¸§åŠ¨ç”»ã€è¡¥é—´åŠ¨ç”»å’Œå±æ€§åŠ¨ç”»çš„æ€»ç»“åˆ†äº«
SpongeAPI:        A Minecraft plugin API
WeaponApp:        ä¸€ä¸ªå°½é‡åšåˆ°æè‡´çš„é›†å¤§æˆAppï¼ŒåŠªåŠ›åšåˆ°æœ€å¥½(å¼€å‘é˜¶æ®µ)â€”â€”MVVM+Retrofit+RxJava+Small æ’ä»¶åŒ–+å•å…ƒæµ‹è¯•+MD
Android-Easy-MultiDex:        [Deprecated] Androidï¼Œmultidexï¼Œsplitdexï¼Œåˆ†åŒ…æ’ä»¶
Fetch:        The best file downloader library for Android
android-basic-samples:        Google Play game services - Android samples
Android-Cookbook-Examples:        Contributed code examples from O'Reilly Android Cookbook. See #user-content-table README below!
Shield:        A declarative, efficient, and flexible Native framework for building user interfaces.
ByteX:        ByteX is a bytecode plugin platform based on Android Gradle Transform API and ASM. å­—èŠ‚ç æ’ä»¶å¼€å‘å¹³å°
gradle-intellij-plugin:        Plugin for building plugins for IntelliJ IDEs
Hunter:        A fast, incremental, concurrent framework to develop compile plugin for android project to manipulate bytecode
BestNote:        ğŸ‘Š æŒç»­æ›´æ–°ï¼ŒJava Android è¿‘å‡ å¹´æœ€å…¨é¢çš„æŠ€æœ¯ç‚¹ä»¥åŠé¢è¯•é¢˜ ä¾›è‡ªå·±å­¦ä¹ ä½¿ç”¨
Android-Next:        Android Next å…¬å…±ç»„ä»¶åº“
McImage:        Android Gradle Plugin -- Auto Check big image and compress image in building.
gradle-completion:        Gradle tab completion for bash and zsh
FS-Blog:        ä¸ªäººåšå®¢ï¼ŒSpring Boot å¼€å±±ä¹‹ä½œï¼Œé‡‡ç”¨ Spring Boot + MyBatisï¼Œå‰ç«¯ Bootstrap + LayUIï¼Œæ”¯æŒç¨‹åºå‘˜éå¸¸é’ççš„è½»é‡åŒ–çš„ Markdown ç¼–è¾‘å™¨ Editor.mdï¼Œæ”¯æŒæ ‡ç­¾åˆ†ç±»æ£€ç´¢
fod:        Freedom of Developers
gogradle:        A Gradle Plugin Providing Full Support for Go
light-novel-library_Wenku8_Android:        [CASUALLY MAINTAINED] è½»å°è¯´æ–‡åº“ (Wenku8.com) å®‰å“ç‰ˆç¬¬ä¸‰æ–¹å…¬ç›ŠAppï¼Œå§‹äº2014å¹´çš„Material Designé£æ ¼ã€æ— å¹¿å‘Šã€ä¸ç›ˆåˆ©çš„è½»å°è¯´é˜…è¯»å™¨(light novel reader)ã€‚
ok-gradle:        IntelliJ/Android Studio plugin for searching artifacts ids of popular Java libraries.
gradle-docker:        a Gradle plugin for orchestrating docker builds and pushes.
kotlin-android-template:        Android + Kotlin + Github Actions + ktlint + Detekt + Gradle Kotlin DSL + buildSrc = â¤ï¸
deep-clean:        When Gradle or the IDE let you down, just --nuke all them caches
StringFog:        ä¸€æ¬¾è‡ªåŠ¨å¯¹å­—èŠ‚ç ä¸­çš„å­—ç¬¦ä¸²è¿›è¡ŒåŠ å¯†Androidæ’ä»¶å·¥å…·
AndroidSDK:        ğŸ³ Full-fledged Android SDK Docker Image
BottomDialogs:        An Android library that shows a customizable Material-based bottom sheet. API 11+ required.
Applozic-Android-SDK:        Android Real Time Chat & Messaging SDK
kotlin-frontend-plugin:        Gradle Kotlin (http://kotlinlang.org) plugin for frontend development
hibeaver:        HiBeaver is a gradle plugin for java byte code manipulation and AOP design by modifying project byte code during build of the package, or modifying byte code within Jar independently.
java-sdk:        ğŸ¥‡ Java SDK to use the IBM Watson services.
Charlatano:        Proves JVM cheats are viable on native games, and demonstrates the longevity against anti-cheat signature detection systems
refreshVersions:        Life is too short to google for dependencies and versions
spock-example:        Spock example specifications along with ready-to-go Gradle and Maven builds
gradle-git:        Git plugin for Gradle
adblockfast:        Adblock Fast is a new, faster ad blocker for Android, iOS, Chrome, and Opera.
ktlint-gradle:        A ktlint gradle plugin
let:        Annotation based simple API flavored with AOP to handle new Android runtime permission model
Learning-Resources:        "Technology Gold mine" to collect and share materials/resources
gradle-advanced-build-version:        A plugin to generate the Android version code and version name automatically based on git commits number, date and ...
pygradle:        Using Gradle to build Python projects
arcgis-runtime-samples-android:        ArcGIS Runtime SDK for Android Samples
MinecraftDev:        Plugin for IntelliJ IDEA that gives special support for Minecraft modding projects.
XAOP:        ğŸ”¥ä¸€ä¸ªè½»é‡çº§çš„AOP(Android)åº”ç”¨æ¡†æ¶ã€‚å›Šæ‹¬äº†æœ€å®ç”¨çš„AOPåº”ç”¨ã€‚
LazierTracker:        æœ¬é¡¹ç›®é€šè¿‡Androidå­—èŠ‚ç æ’æ¡©æ’ä»¶å®ç°Androidç«¯æ— åŸ‹ç‚¹ï¼ˆæˆ–è‡ªåŠ¨åŸ‹ç‚¹ï¼‰ï¼Œå¹¶ä¸”æ”¯æŒæ ¹æ®é…ç½®æ–‡ä»¶å®ç°ä¸šåŠ¡æ•°æ®çš„è‡ªåŠ¨é‡‡é›†ã€‚
gradle-in-action-source:        Source code for the Manning book "Gradle in Action"
android-studio-poet:        Generate large Android Studio projects
android-tech-docs:        Androidå®˜æ–¹æŠ€æœ¯æ–‡æ¡£ç¿»è¯‘
VBrowser-Android:        å…¨ç½‘è§†é¢‘å—…æ¢ç¼“å­˜APP
gradle-download-task:        Adds a download task to Gradle that displays progress information
GradleKotlinConverter:        Convert from Groovy to Kotlin DSL for Gradle, focused on Android.
bnd:        Bnd/Bndtools. Tooling to build OSGi bundles including Eclipse, Maven, and Gradle plugins.
gradle-xcodePlugin:        gradle plugin for building Xcode Projects for iOS, watchOS, macOS or tvOS
Gradle-Plugin-User-Guide-Chinese-Verision:        Gradle Plugin User Guide ä¸­æ–‡ç¿»è¯‘
Railcraft:        The Railcraft Mod for Minecraft, source and development.
photofilter:        A simple easy to use library that lets you edit pictures on the fly with easy. Photo filter lets you apply a large number of filters all while maintaining maximum image quality. Supports Android 2.3 and higher.
javafx-gradle-plugin:        Gradle plugin for JavaFX
gradle-lint-plugin:        A pluggable and configurable linter tool for identifying and reporting on patterns of misuse or deprecations in Gradle scripts.
MarkdownView-Android:        MarkdownView is an Android webview with the capability of loading Markdown text or file and display it as HTML, it extends Android webview.