TensorFlow is an open source software library for numerical computation.
tensorflow:        An Open Source Machine Learning Framework for Everyone
keras:        Deep Learning for humans
TensorFlow-Examples:        TensorFlow Tutorial and Examples for Beginners (support TF v1 & v2)
transformers:        ğŸ¤—Transformers: State-of-the-art Natural Language Processing for Pytorch and TensorFlow 2.0.
gold-miner:        ğŸ¥‡æ˜é‡‘ç¿»è¯‘è®¡åˆ’ï¼Œå¯èƒ½æ˜¯ä¸–ç•Œæœ€å¤§æœ€å¥½çš„è‹±è¯‘ä¸­æŠ€æœ¯ç¤¾åŒºï¼Œæœ€æ‡‚è¯»è€…å’Œè¯‘è€…çš„ç¿»è¯‘å¹³å°ï¼š
basics:        ğŸ“š Learn ML with clean code, simplified math and illustrative visuals.
bert:        TensorFlow code and pre-trained models for BERT
handson-ml:        A series of Jupyter notebooks that walk you through the fundamentals of Machine Learning and Deep Learning in python using Scikit-Learn and TensorFlow.
data-science-ipython-notebooks:        Data science Python notebooks: Deep learning (TensorFlow, Theano, Caffe, Keras), scikit-learn, Kaggle, big data (Spark, Hadoop MapReduce, HDFS), matplotlib, pandas, NumPy, SciPy, Python essentials, AWS, and various command lines.
Real-Time-Voice-Cloning:        Clone a voice in 5 seconds to generate arbitrary speech in real-time
Mask_RCNN:        Mask R-CNN for object detection and instance segmentation on Keras and TensorFlow
100-Days-Of-ML-Code:        100-Days-Of-ML-Codeä¸­æ–‡ç‰ˆ
TensorFlow-Course:        Simple and ready-to-use tutorials for TensorFlow
DeepSpeech:        A TensorFlow implementation of Baidu's DeepSpeech architecture
spleeter:        Deezer source separation library including pretrained models.
Virgilio:        Your new Mentor for Data Science E-Learning.
facenet:        Face recognition using Tensorflow
face-api.js:        JavaScript API for face detection and face recognition in the browser and nodejs with tensorflow.js
netron:        Visualizer for neural network, deep learning and machine learning models
DeepCreamPy:        Decensoring Hentai with Deep Neural Networks
stanford-tensorflow-tutorials:        This repository contains code examples for the Stanford's course: TensorFlow for Deep Learning Research.
horovod:        Distributed training framework for TensorFlow, Keras, PyTorch, and Apache MXNet.
Deep-Learning-with-TensorFlow-book:        æ·±åº¦å­¦ä¹ å…¥é—¨å¼€æºä¹¦ï¼ŒåŸºäºTensorFlow 2.0æ¡ˆä¾‹å®æˆ˜ã€‚Open source Deep Learning book, based on TensorFlow 2.0 framework.
tflearn:        Deep learning library featuring a higher-level API for TensorFlow.
ncnn:        ncnn is a high-performance neural network inference framework optimized for the mobile platform
kubeflow:        Machine Learning Toolkit for Kubernetes
dopamine:        Dopamine is a research framework for fast prototyping of reinforcement learning algorithms.
onnx:        Open standard for machine learning interoperability
EffectiveTensorflow:        TensorFlow tutorials and best practices.
sonnet:        TensorFlow-based neural network library
TensorFlow-Tutorials:        TensorFlow Tutorials with YouTube Videos
tutorials:        æœºå™¨å­¦ä¹ ç›¸å…³æ•™ç¨‹
bert-as-service:        Mapping a variable-length sentence to a fixed-length vector using BERT model
mit-deep-learning:        Tutorials, assignments, and competitions for MIT Deep Learning related courses.
autokeras:        AutoML library for deep learning
faceai:        ä¸€æ¬¾å…¥é—¨çº§çš„äººè„¸ã€è§†é¢‘ã€æ–‡å­—æ£€æµ‹ä»¥åŠè¯†åˆ«çš„é¡¹ç›®.
DCGAN-tensorflow:        A tensorflow implementation of "Deep Convolutional Generative Adversarial Networks"
nlp-tutorial:        Natural Language Processing Tutorial for Deep Learning Researchers
nni:        An open source AutoML toolkit for automate machine learning lifecycle, including feature engineering, neural architecture search, model compression and hyper-parameter tuning.
text_classification:        all kinds of text classification models and more with deep learning
d2l-en:        Interactive deep learning book with code, math, and discussions. Available in multi-frameworks.
tensorlayer:        Deep Learning and Reinforcement Learning Library for Scientists and Engineers ğŸ”¥
generative-models:        Collection of generative models, e.g. GAN, VAE in Pytorch and Tensorflow.
python-machine-learning-book-2nd-edition:        The "Python Machine Learning (2nd edition)" book code repository and info resource
deepo:        Set up deep learning environment in a single command line.
photoprism:        Personal Photo Management powered by Go and Google TensorFlow
tensorflow_cookbook:        Code for Tensorflow Machine Learning Cookbook
tensorpack:        A Neural Net Training Interface on TensorFlow, with focus on speed + flexibility
darkflow:        Translate darknet to tensorflow. Load trained weights, retrain/fine-tune using tensorflow, export constant graph def to mobile devices
swift:        Swift for TensorFlow
xlnet:        XLNet: Generalized Autoregressive Pretraining for Language Understanding
seq2seq:        A general-purpose encoder-decoder framework for Tensorflow
TensorFlow-2.x-Tutorials:        TensorFlow 2.x version's Tutorials and Examples, including CNN, RNN, GAN, Auto-Encoders, FasterRCNN, GPT, BERT examples, etc. TF 2.0ç‰ˆå…¥é—¨å®ä¾‹ä»£ç ï¼Œå®æˆ˜æ•™ç¨‹ã€‚
eat_tensorflow2_in_30_days:        Tensorflow2.0 ğŸğŸŠ is delicious, just eat it! ğŸ˜‹ğŸ˜‹
TopDeepLearning:        A list of popular github projects related to deep learning
MMdnn:        MMdnn is a set of tools to help users inter-operate among different deep learning frameworks. E.g. model conversion and visualization. Convert models between Caffe, Keras, MXNet, Tensorflow, CNTK, PyTorch Onnx and CoreML.
Learning-to-See-in-the-Dark:        Learning to See in the Dark. CVPR 2018
python-small-examples:        å‘Šåˆ«æ¯ç‡¥ï¼Œè‡´åŠ›äºæ‰“é€  Python å¯Œæœ‰ä½“ç³»ä¸”å®ç”¨çš„å°ä¾‹å­ã€å°æ¡ˆä¾‹ã€‚
keras-js:        Run Keras models in the browser, with GPU support using WebGL
keras-rl:        Deep Reinforcement Learning for Keras.
alluxio:        Alluxio, data orchestration for analytics and machine learning in the cloud
edward:        A probabilistic programming language in TensorFlow. Deep generative models, variational inference.
serving:        A flexible, high-performance serving system for machine learning models
TensorFlow-World:        ğŸŒ Simple and ready-to-use tutorials for TensorFlow
graph_nets:        Build Graph Nets in Tensorflow
DeepPavlov:        An open source library for deep learning end-to-end dialog systems and chatbots.
TensorFlow-Book:        Accompanying source code for Machine Learning with TensorFlow. Refer to the book for step-by-step explanations.
sketch-code:        Keras model to generate HTML code from hand-drawn website mockups. Implements an image captioning architecture to drawn source images.
tensorspace:        Neural network 3D visualization framework, build interactive and intuitive model in browsers, support pre-trained deep learning models from TensorFlow, Keras, TensorFlow.js
Practical_RL:        A course in reinforcement learning in the wild
pipeline:        PipelineAI Kubeflow Distribution
DeepLearningZeroToAll:        TensorFlow Basic Tutorial Labs
textgenrnn:        Easily train your own text-generating neural network of any size and complexity on any text dataset with a few lines of code.
SSD-Tensorflow:        Single Shot MultiBox Detector in TensorFlow
cvat:        Powerful and efficient Computer Vision Annotation Tool (CVAT)
lucid:        A collection of infrastructure and tools for research in neural network interpretability.
Tensorflow-Tutorial:        Tensorflow tutorial from basic to hard
CapsNet-Tensorflow:        A Tensorflow implementation of CapsNet(Capsules Net) in paper Dynamic Routing Between Capsules
tensorflow-docs:        TensorFlow æœ€æ–°å®˜æ–¹æ–‡æ¡£ä¸­æ–‡ç‰ˆ
tensorflow-generative-model-collections:        Collection of generative models in Tensorflow
docs:        TensorFlow documentation
examples:        TensorFlow examples
TensorFlowOnSpark:        TensorFlowOnSpark brings TensorFlow programs to Apache Spark clusters.
HyperLPR:        åŸºäºæ·±åº¦å­¦ä¹ é«˜æ€§èƒ½ä¸­æ–‡è½¦ç‰Œè¯†åˆ« High Performance Chinese License Plate Recognition Framework.
tf-faster-rcnn:        Tensorflow Faster RCNN for Object Detection
tf-pose-estimation:        Deep Pose Estimation implemented using Tensorflow with Custom Architectures for fast inference.
Chinese-BERT-wwm:        Pre-Training with Whole Word Masking for Chinese BERTï¼ˆä¸­æ–‡BERT-wwmç³»åˆ—æ¨¡å‹ï¼‰
hands-on-ml-zh:        ğŸ“– [è¯‘] Sklearn ä¸ TensorFlow æœºå™¨å­¦ä¹ å®ç”¨æŒ‡å—ã€ç‰ˆæƒé—®é¢˜ï¼Œç½‘ç«™å·²ä¸‹çº¿ï¼ï¼ã€‘
gocv:        Go package for computer vision using OpenCV 4 and beyond.
SmartCropper:        ğŸ”¥ A library for cropping image in a smart way that can identify the border and correct the cropped image. æ™ºèƒ½å›¾ç‰‡è£å‰ªæ¡†æ¶ã€‚è‡ªåŠ¨è¯†åˆ«è¾¹æ¡†ï¼Œæ‰‹åŠ¨è°ƒèŠ‚é€‰åŒºï¼Œä½¿ç”¨é€è§†å˜æ¢è£å‰ªå¹¶çŸ«æ­£é€‰åŒºï¼›é€‚ç”¨äºèº«ä»½è¯ï¼Œåç‰‡ï¼Œæ–‡æ¡£ç­‰ç…§ç‰‡çš„è£å‰ªã€‚