WordPress is a popular content management system, used for websites and blogs.
stackedit:        In-browser Markdown editor
wp-calypso:        The JavaScript and API powered WordPress.com
nginxconfig.io:        âš™ï¸ NGINX config generator on steroids ğŸ’‰
sage:        WordPress starter theme with a modern development workflow
woocommerce:        An open source eCommerce plugin for WordPress.
gutenberg:        The Block Editor project for WordPress and beyond. Plugin is available from the official repository.
wpscan:        WPScan is a free, for non-commercial use, black box WordPress security scanner written for security professionals and blog maintainers to test the security of their WordPress websites.
bedrock:        WordPress boilerplate with modern development tools, easier configuration, and an improved folder structure
VVV:        An open source Vagrant configuration for developing with WordPress
timber:        Create WordPress themes with beautiful OOP code and the Twig Template Engine
wp-cli:        âš™ï¸ WP-CLI framework
headless-wp-starter:        ğŸ”ª WordPress + React Starter Kit: Spin up a WordPress-powered React app in one step
wp-bootstrap-navwalker:        A custom WordPress nav walker class to fully implement the Twitter Bootstrap 4.0+ navigation style (v3-branch available for Bootstrap 3) in a custom theme using the WordPress built in menu manager.
WordPress-iOS:        WordPress for iOS - Official repository
corcel:        Use WordPress backend with Laravel or any PHP application
FoundationPress:        FoundationPress is a WordPress starter theme based on Foundation 6 by Zurb
create-guten-block:        ğŸ“¦ A zero-configuration #0CJS developer toolkit for building WordPress Gutenberg block plugins.
CMB2:        CMB2 is a developer's toolkit for building metaboxes, custom fields, and forms for WordPress that will blow your mind.
wp-graphql:        ğŸš€ GraphQL API for WordPress
lando:        A local development and DevOps tool for all your projects that is fast, easy, powerful and liberating
WordPress-Android:        WordPress for Android
versionpress:        Git-based version control for WordPress. Whoa!
trellis:        Ansible playbooks for a WordPress LEMP stack
easyengine:        Command-line control panel for Nginx Server to manage WordPress sites running on Nginx, PHP, MySQL, and Let's Encrypt
wordmove:        Multi-stage command line deploy/mirroring and task runner for Wordpress
data.gov:        Data.gov source code and issue tracker
amp-wp:        Enable AMP on your WordPress site, the WordPress way.
Sakura:        A Wonderful WordPress Theme: æ¨±èŠ±åº„çš„ç™½çŒ«åšå®¢ä¸»é¢˜
wordpress-bootstrap:        Bootstrap in WordPress theme form - Bootstrap 3.3.1
plugin-update-checker:        A custom update checker for WordPress plugins. Useful if you don't want to host your project in the official WP repository, but would still like it to support automatic updates. Despite the name, it also works with themes.
RED_HAWK:        All in one tool for Information Gathering, Vulnerability Scanning and Crawling. A must have tool for all penetration testers
wordless:        All the power of Pug, Sass, Coffeescript and WebPack in your WordPress theme. Stop writing themes like it's 1998.
S3-Uploads:        The WordPress Plugin to Store Uploads on Amazon S3
wordplate:        WordPlate is a wrapper around WordPress to make developers life easier. It is just like building any other WordPress website with themes and plugins. Just with sprinkles on top.
wordpressify:        ğŸˆ A build system designed to automate your WordPress development workflow.
frontity:        Â» Frontity - The React framework for WordPress
wordpress-seo:        Yoast SEO for WordPress
jetpack:        Increase your traffic, view your stats, speed up your site, and protect yourself from hackers with Jetpack.
vuejs-wordpress-theme-starter:        A WordPress theme with the guts ripped out and replaced with Vue.
CMS-Hunter:        CMSæ¼æ´æµ‹è¯•ç”¨ä¾‹é›†åˆ
kirki:        Extending the customizer
theme:        Tonik is a WordPress Starter Theme which aims to modernize, organize and enhance some aspects of WordPress theme development.
kubernetes-course:        Kubernetes Course Files
CMSeeK:        CMS Detection and Exploitation suite - Scan WordPress, Joomla, Drupal and over 180 other CMSs
vv:        ğŸŒ Variable VVV - a VVV Site Creation Wizard.â€ â€ â€ â€ â€ â€ â€ â€ â€ â€ â€ â€ â€ â€ â€ â€ â€ â€ â€ â€ â€ â€ â€ â€ â€ â€ â€ â€ â€ â€ â€ â€ â€ â€ â€ â€ â€ â€ â€ â€ â€ â€ â€ â€ â€ â€ â€ â€ â€ â€ â€ â€ â€ â€ â€ âŒ This project is no longer maintained. Please update your copy of VVV , which has most of the vv features built in.
query-monitor:        The Developer Tools Panel for WordPress
acf-to-rest-api:        Exposes Advanced Custom Fields Endpoints in the WordPress REST API
themosis:        A framework for WordPress developers.
wprig:        A progressive theme development rig for WordPress.
WordPress-Widget-Boilerplate:        [WordPress] The WordPress Widget Boilerplate is an organized, maintainable boilerplate for building widgets using WordPress best practices.
hybrid:        [I don't have time to work on this anymore. Use at your own risk] Build WordPress based PWA, iOS, Android & Windows phones apps in minutes!
vccw:        A Vagrant based development environment.
meta-box:        The best plugin for WordPress custom fields and custom meta boxes
wp-functions:        A compilation of function snippets for WordPress developers who create their own themes.
MarkdownMonster:        An extensible Markdown Editor, Viewer and Weblog Publisher for Windows
ElasticPress:        A fast and flexible search and query engine for WordPress.
wordpress-to-jekyll-exporter:        One-click WordPress plugin that converts all posts, pages, taxonomies, metadata, and settings to Markdown and YAML which can be dropped into Jekyll
wp-posts-to-posts:        Efficient many-to-many connections between posts, pages, custom post types, users.
wordpress-docker-compose:        Easy Wordpress development with Docker and Docker Compose
Diaspora:        Diaspora - A WordPress theme
site-kit-wp:        Site Kit is a one-stop solution for WordPress users to use everything Google has to offer to make them successful on the web.
Unyson:        A WordPress framework that facilitates the development of WP themes
heroku-wp:        WordPress on Heroku
gantry5:        ğŸš€ Next Generation Template / Theme Framework
pods:        The Pods Framework is a Content Development Framework for WordPress - It lets you create and extend content types that can be used for any project. Add fields of various types we've built in, or add your own with custom inputs, you have total control.
wordpress-admin-style:        Shows the WordPress admin styles on one page to help you to develop WordPress compliant
wp-desktop:        WordPress.com for Desktop
wordpress-exploit-framework:        A Ruby framework designed to aid in the penetration testing of WordPress systems.
XAttacker:        X Attacker Tool â˜£ Website Vulnerability Scanner & Auto Exploiter
CMSScan:        CMS Scanner: Scan Wordpress, Drupal, Joomla, vBulletin websites for Security issues
WPSeku:        WPSeku - Wordpress Security Scanner
easy-digital-downloads:        Sell digital downloads through WordPress
wordpress-multi-env-config:        WordPress Multi-Environment Config
ddev:        DDEV-Local: a local PHP development environment system
storefront:        Official theme for WooCommerce
wordpress-gulp-starter-kit:        [NOT MAINTAINED] A starter kit for developing WordPress themes with Gulp.
wp2static:        WordPress static site generator for security, performance and cost benefits
vue-wordpress-pwa:        An offline-first SPA using Vue.js, the WordPress REST API and Progressive Web Apps
extended-cpts:        A library which provides extended functionality to WordPress custom post types and taxonomies.
wysiwyg.css:        A tiny CSS for generated HTML or Markdown content
facebook-instant-articles-wp:        Enable Facebook Instant Articles on your WordPress site.
presspack:        ğŸ’» Wordpress like it's 2020 with Webpack and Docker
Chassis:        ğŸ“¦ Chassis is a virtual server for your WordPress site, built using Vagrant.
WPForce:        Wordpress Attack Suite
framework:        The Themosis framework core.
docker4wordpress:        Docker-based WordPress stack
odin:        Framework and base theme for development with WordPress.
MerlinWP:        Better WordPress Theme Onboarding
casper:        Casper ğŸ‘» theme for Wordpress
WP-Editor.md:        æˆ–è®¸è¿™æ˜¯ä¸€ä¸ªWordPressä¸­æœ€å¥½ï¼Œæœ€å®Œç¾çš„Markdownç¼–è¾‘å™¨