Ansible is a simple and powerful automation engine.
ansible:        Ansible is a radically simple IT automation platform that makes your applications and systems easier to deploy. Avoid writing scripts or custom code to deploy and update your applications â€” automate in a language that approaches plain English, using SSH, with no agents to install on remote systems. https://docs.ansible.com/ansible/
streisand:        Streisand sets up a new server running your choice of WireGuard, OpenConnect, OpenSSH, OpenVPN, Shadowsocks, sslh, Stunnel, or a Tor bridge. It also generates custom instructions for all of these services. At the end of the run you are given an HTML file with instructions that can be shared with friends, family members, and fellow activists.
algo:        Set up a personal VPN in the cloud
kubespray:        Deploy a Production Ready Kubernetes Cluster
awx:        AWX Project
devops-exercises:        Linux, Jenkins, AWS, SRE, Prometheus, Docker, Python, Ansible, Git, Kubernetes, Terraform, OpenStack, SQL, NoSQL, Azure, GCP, DNS, Elastic, Network, Virtualization
kubeasz:        ä½¿ç”¨Ansibleè„šæœ¬å®‰è£…K8Sé›†ç¾¤ï¼Œä»‹ç»ç»„ä»¶äº¤äº’åŸç†ï¼Œæ–¹ä¾¿ç›´æ¥ï¼Œä¸å—å›½å†…ç½‘ç»œç¯å¢ƒå½±å“
rundeck:        Enable Self-Service Operations: Give specific users access to your existing tools, services, and scripts
semaphore:        Open Source alternative to Ansible Tower
ansible-for-devops:        Ansible examples from Ansible for DevOps.
DevOps-Guide:        DevOps Guide from basic to advanced with Interview Questions and Notes ğŸ”¥
mac-dev-playbook:        Mac setup and configuration via Ansible.
molecule:        Molecule aids in the development and testing of Ansible roles
KubeOperator:        KubeOperator æ˜¯ä¸€ä¸ªå¼€æºçš„è½»é‡çº§ Kubernetes å‘è¡Œç‰ˆï¼Œä¸“æ³¨äºå¸®åŠ©ä¼ä¸šè§„åˆ’ã€éƒ¨ç½²å’Œè¿è¥ç”Ÿäº§çº§åˆ«çš„ K8s é›†ç¾¤ã€‚
OpsManage:        è‡ªåŠ¨åŒ–è¿ç»´å¹³å°: ä»£ç åŠåº”ç”¨éƒ¨ç½²CI/CDã€èµ„äº§ç®¡ç†CMDBã€è®¡åˆ’ä»»åŠ¡ç®¡ç†å¹³å°ã€SQLå®¡æ ¸|å›æ»šã€ä»»åŠ¡è°ƒåº¦ã€ç«™å†…WIKI
opendevops:        CODOæ˜¯ä¸€æ¬¾ä¸ºç”¨æˆ·æä¾›ä¼ä¸šå¤šæ··åˆäº‘ã€ä¸€ç«™å¼DevOpsã€è‡ªåŠ¨åŒ–è¿ç»´ã€å®Œå…¨å¼€æºçš„äº‘ç®¡ç†å¹³å°ã€è‡ªåŠ¨åŒ–è¿ç»´å¹³å°
ansible-lint:        Best practices checker for Ansible
trellis:        Ansible playbooks for a WordPress LEMP stack
netboot.xyz:        Network bootable operating system installer based on iPXE
deploy:        Ansible role to deploy scripting applications like PHP, Python, Ruby, etc. in a capistrano style
openshift-ansible:        Install and config an OpenShift 3.x cluster
ansible-vagrant-examples:        Ansible examples using Vagrant to deploy to local VMs.
werf:        GitOps delivery tool
ansible-tuto:        Ansible tutorial
ansible-cmdb:        Generate host overview from ansible fact gathering output
testinfra:        Testinfra test your infrastructures
chrome-aws-lambda:        Chromium Binary for AWS Lambda and Google Cloud Functions
ansible-os-hardening:        This Ansible role provides numerous security-related configurations, providing all-round base protection.
infrastructure-as-code-tutorial:        Infrastructure As Code Tutorial. Covers Packer, Terraform, Ansible, Vagrant, Docker, Docker Compose, Kubernetes
PlexGuide.com:        Welcome to https://PlexGuide.com ~ Rapidly deploy multiple-hasty Docker Containers through Ansible with local or Unlimited Google HD Space!
terraform-inventory:        Terraform State â†’ Ansible Dynamic Inventory
vps-comparison:        A comparison between some VPS providers. It uses Ansible to perform a series of automated benchmark tests over the VPS servers that you specify. It allows the reproducibility of those tests by anyone that wanted to compare these results to their own. All the tests results are available in order to provide independence and transparency.
drupal-vm:        A VM for Drupal development
ansible-interactive-tutorial:        Interactive Ansible tutorials with dead simple setup via Docker
learning-tools:        A collection of tools and files for learning new technologies
starhackit:        StarHackIt: React/Native/Node fullstack starter kit with authentication and authorisation, data backed by SQL.
Cloudbox:        Ansible-based solution for rapidly deploying a Docker containerized cloud media server.
ceph-ansible:        Ansible playbooks to deploy Ceph, the distributed filesystem.
ansible-elasticsearch:        Ansible playbook for Elasticsearch
web_develop:        ã€ŠPython Webå¼€å‘å®æˆ˜ã€‹ä¹¦ä¸­æºç 
vpn-at-home:        1-click, self-hosted deployment of OpenVPN with DNS ad blocking sinkhole
raspberry-pi-dramble:        Raspberry Pi Kubernetes cluster that runs HA/HP Drupal 8
ara:        ARA Records Ansible playbooks and makes them easier to understand and troubleshoot. This is the GitHub mirror for https://opendev.org/recordsansible/ara.
manageiq:        ManageIQ Open-Source Management Platform
content:        Security automation content in SCAP, OSCAL, Bash, Ansible, and other formats
ansible-nas:        Build a full-featured home server or NAS replacement with an Ubuntu box and this playbook.
breeze:        Deploy a Production Ready Kubernetes Cluster with graphical interface
dank-selfhosted:        Automated solution for hosting email, web, DNS, XMPP, and ZNC on OpenBSD.
configuration:        A collection of edx configuration scripts and utilities that edx.org uses to deploy openedx.
ansible-role-mysql:        Ansible Role - MySQL
workshops:        Training Course for Ansible Automation Platform
ansible-best-practises:        A project structure that outlines some best practises of how to use ansible
mysqltools:        ä¸€ä¸ªç”¨äºå¿«é€Ÿæ„å»ºå¤§è§„æ¨¡ï¼Œé«˜è´¨é‡ï¼Œå…¨è‡ªåŠ¨åŒ–çš„ mysqlåˆ†å¸ƒå¼é›†ç¾¤ç¯å¢ƒçš„å·¥å…·ï¼›åŒ…å«mysql å®‰è£…ã€å¤‡ä»½ã€ç›‘æ§ã€é«˜å¯ç”¨ã€è¯»å†™åˆ†ç¦»ã€ä¼˜åŒ–ã€å·¡æ£€ã€è‡ªè¡ŒåŒ–è¿ç»´
ansible-ssh-hardening:        This Ansible role provides numerous security-related ssh configurations, providing all-round base protection.
opscloud:        è¿ç»´ç®¡ç†å¹³å°(é˜¿é‡Œäº‘)ï¼Œè‡ªåŠ¨åŒæ­¥é˜¿é‡Œäº‘é…ç½®ä¿¡æ¯ï¼Œå ¡å’æœºï¼ˆå®¹å™¨ï¼‰ï¼Œæ‰¹é‡è¿ç»´ï¼ŒKubernetesï¼ŒZabbixç®¡ç†ç­‰åŠŸèƒ½
ansible-role-docker:        Ansible Role - Docker
ansible-role-jenkins:        Ansible Role - Jenkins CI
postgresql:        Fairly full featured Ansible role for Postgresql.
debops:        DebOps - Your Debian-based data center in a box
ansible-role-nginx:        Ansible role for NGINX
ansible-prometheus:        Deploy Prometheus monitoring system
ansible-vim:        A vim plugin for syntax highlighting Ansible's common filetypes
op-note:        å½“æˆ‘æœ‰æœåŠ¡å™¨æ—¶æˆ‘åšäº†ä»€ä¹ˆ Â· ä¸ªäººæœåŠ¡å™¨è¿ç»´æŒ‡å—
drill:        Drill is a HTTP load testing application written in Rust inspired by Ansible syntax
ios-dev-playbook:        ä¸ä¼šè¿ç»´çš„ iOS å¼€å‘ä¸æ˜¯å¥½è®¾è®¡å¸ˆã€‚è¿™ä¸ª Ansible Playbook èƒ½å¿«é€Ÿé…ç½® iOS å¼€å‘éœ€è¦çš„æœåŠ¡ï¼Œå®‰è£…å¦‚ Gogsã€GitLabã€Jenkinsã€Ghostã€Ajenti ç­‰å¸¸ç”¨æœåŠ¡ã€‚
ansible-docker:        Install / Configure Docker and Docker Compose using Ansible.
kubeadm-playbook:        Fully fledged (HA) Kubernetes Cluster using official kubeadm, ansible and helm. Tested on RHEL/CentOS/Ubuntu with support of http_proxy, dashboard installed, ingress controller, heapster - using official helm charts
polemarch:        Simple WEB gui for infrastructure management by ansible playbooks or modules. This is only mirror with bins in releases.
aspnet-core-react-template:        ASP.NET Core 3.1 / React SPA Template App
terraform-provisioner-ansible:        Marrying Ansible with Terraform 0.12.x
lain:        LAIN's main repo
docker.ubuntu:        Docker role for Ansible on Ubuntu 14.04+
debops-wordpress:        Your superpowered WordPress server in three commands.
ansible-letsencrypt:        An ansible role to generate TLS certificates and get them signed by Let's Encrypt
Ops:        åŸºäºcentos6+python3.6+django2+ansible2.4+celery4.2 è¿ç»´ç®¡ç†ç³»ç»Ÿï¼Œç›®å‰å®ç°åŠŸèƒ½ï¼šç”¨æˆ·å’Œç”¨æˆ·ç»„ç®¡ç†ã€èµ„äº§ç®¡ç†ã€é›†æˆansible2.4ã€ç®€æ˜“å ¡å’æœº(ä¸»æœºåˆ†é…æ”¯æŒrdpä»¥åŠvncã€ç”¨æˆ·åˆ†é…ã€æ–‡ä»¶ä¸Šä¼ ä¸‹è½½ã€é…ç½®ç¦ç”¨å‘½ä»¤æ¸…å•ã€æ“ä½œå½•åƒå›æ”¾åŠŸèƒ½)ã€CI/CDï¼ˆæ”¯æŒgitä»“åº“å’Œsvnä»“åº“ï¼‰ã€æ•°æ®åº“ç®¡ç†ï¼ˆä¸€éƒ¨åˆ†ï¼‰ã€celeryä»»åŠ¡ç¼–æ’ã€çŸ¥è¯†åº“åŠæ–‡ä»¶å…±äº«
kubeadm-ansible:        Build a Kubernetes cluster using kubeadm via Ansible.
ansible-role-certbot:        Ansible Role - Certbot (for Let's Encrypt)
ansible-lockdown:        Ansible playbook roles for security
ansigenome:        A tool to help you gather information and manage your Ansible roles.
ansible-role-gitlab:        Ansible Role - GitLab
packer-boxes:        Jeff Geerling's Packer build configurations for Vagrant boxes.
docker-ansible:        Docker images for Ansible software, installed in a selected Linux distributions (Debian/Ubuntu/CentOS/Alpine).
xxproject:        SpringCloud å¾®æœåŠ¡ç»¼åˆå®ä¾‹ã€‚åˆ†å¸ƒå¼é…ç½®ä¸­å¿ƒï¼ŒæœåŠ¡å‘ç°&è´Ÿè½½å‡è¡¡ï¼Œé“¾è·¯æ–­è·¯å™¨ï¼ŒAPIç½‘å…³ï¼ŒOAuth2è®¤è¯æˆæƒï¼Œåˆ†å¸ƒå¼è¿½è¸ªï¼ŒELKæ—¥å¿—ä¸­å¿ƒï¼ŒAnsible/DockeræŒç»­äº¤ä»˜ç­‰æœ€ä½³å®è·µã€‚
ansible-role-php:        Ansible Role - PHP
ansible-provisioning:        Ansible provisioning framework - a set of modules, plugins, and documentation for provisioning with Ansible
tads-boilerplate:        Terraform + Ansible + Docker Swarm boilerplate = DevOps on ğŸ”¥ğŸ”¥ğŸ”¥ | Infrastructure as Code
ansible-vault:        ansible lookup plugin for secrets stored in Vault(by HashiCorp)
rak8s:        Stand up a Raspberry Pi based Kubernetes cluster with Ansible