Java is an object-oriented programming language used mainly for web, desktop, embedded devices and mobile applications.
CS-Notes:        ğŸ“š æŠ€æœ¯é¢è¯•å¿…å¤‡åŸºç¡€çŸ¥è¯†ã€Leetcodeã€è®¡ç®—æœºæ“ä½œç³»ç»Ÿã€è®¡ç®—æœºç½‘ç»œã€ç³»ç»Ÿè®¾è®¡ã€Javaã€Pythonã€C++
JavaGuide:        ã€ŒJavaå­¦ä¹ +é¢è¯•æŒ‡å—ã€ä¸€ä»½æ¶µç›–å¤§éƒ¨åˆ†Javaç¨‹åºå‘˜æ‰€éœ€è¦æŒæ¡çš„æ ¸å¿ƒçŸ¥è¯†ã€‚
java-design-patterns:        Design patterns implemented in Java
elasticsearch:        Open Source, Distributed, RESTful Search Engine
spring-boot:        Spring Boot
advanced-java:        ğŸ˜® äº’è”ç½‘ Java å·¥ç¨‹å¸ˆè¿›é˜¶çŸ¥è¯†å®Œå…¨æ‰«ç›²ï¼šæ¶µç›–é«˜å¹¶å‘ã€åˆ†å¸ƒå¼ã€é«˜å¯ç”¨ã€å¾®æœåŠ¡ã€æµ·é‡æ•°æ®å¤„ç†ç­‰é¢†åŸŸçŸ¥è¯†ï¼Œåç«¯åŒå­¦å¿…çœ‹ï¼Œå‰ç«¯åŒå­¦ä¹Ÿå¯å­¦ä¹ 
interviews:        Everything you need to know to get the job.
RxJava:        RxJava â€“ Reactive Extensions for the JVM â€“ a library for composing asynchronous and event-based programs using observable sequences for the Java VM.
mall:        mallé¡¹ç›®æ˜¯ä¸€å¥—ç”µå•†ç³»ç»Ÿï¼ŒåŒ…æ‹¬å‰å°å•†åŸç³»ç»ŸåŠåå°ç®¡ç†ç³»ç»Ÿï¼ŒåŸºäºSpringBoot+MyBatiså®ç°ï¼Œé‡‡ç”¨Dockerå®¹å™¨åŒ–éƒ¨ç½²ã€‚ å‰å°å•†åŸç³»ç»ŸåŒ…å«é¦–é¡µé—¨æˆ·ã€å•†å“æ¨èã€å•†å“æœç´¢ã€å•†å“å±•ç¤ºã€è´­ç‰©è½¦ã€è®¢å•æµç¨‹ã€ä¼šå‘˜ä¸­å¿ƒã€å®¢æˆ·æœåŠ¡ã€å¸®åŠ©ä¸­å¿ƒç­‰æ¨¡å—ã€‚ åå°ç®¡ç†ç³»ç»ŸåŒ…å«å•†å“ç®¡ç†ã€è®¢å•ç®¡ç†ã€ä¼šå‘˜ç®¡ç†ã€ä¿ƒé”€ç®¡ç†ã€è¿è¥ç®¡ç†ã€å†…å®¹ç®¡ç†ã€ç»Ÿè®¡æŠ¥è¡¨ã€è´¢åŠ¡ç®¡ç†ã€æƒé™ç®¡ç†ã€è®¾ç½®ç­‰æ¨¡å—ã€‚
guava:        Google core libraries for Java
okhttp:        Squareâ€™s meticulous HTTP client for Java and Kotlin.
retrofit:        A type-safe HTTP client for Android and the JVM
leetcode:        LeetCode Solutions: A Record of My Problem Solving Journey.( leetcodeé¢˜è§£ï¼Œè®°å½•è‡ªå·±çš„leetcodeè§£é¢˜ä¹‹è·¯ã€‚)
MPAndroidChart:        A powerful ğŸš€ Android chart view / graph view library, supporting line- bar- pie- radar- bubble- and candlestick charts as well as scaling, panning and animations.
Java:        All Algorithms implemented in Java
spark:        Apache Spark - A unified analytics engine for large-scale data processing
zxing:        ZXing ("Zebra Crossing") barcode scanning library for Java, Android
leakcanary:        A memory leak detection library for Android.
JCSprout:        ğŸ‘¨â€ğŸ“ Java Core Sprout : basic, concurrent, algorithm
spring-boot-examples:        about learning Spring Boot via examples. Spring Boot æ•™ç¨‹ã€æŠ€æœ¯æ ˆç¤ºä¾‹ä»£ç ï¼Œå¿«é€Ÿç®€å•ä¸Šæ‰‹æ•™ç¨‹ã€‚
jadx:        Dex to Java decompiler
arthas:        Alibaba Java Diagnostic Tool Arthas/Alibaba Javaè¯Šæ–­åˆ©å™¨Arthas
fastjson:        A fast JSON parser/generator for Java.
WxJava:        WxJava ï¼ˆå¾®ä¿¡å¼€å‘ Java SDKï¼‰ï¼Œæ”¯æŒåŒ…æ‹¬å¾®ä¿¡æ”¯ä»˜ã€å¼€æ”¾å¹³å°ã€å°ç¨‹åºã€ä¼ä¸šå¾®ä¿¡/ä¼ä¸šå·å’Œå…¬ä¼—å·ç­‰çš„åç«¯å¼€å‘
selenium:        A browser automation framework and ecosystem.
libgdx:        Desktop/Android/HTML5/iOS Java game development framework
CNTK:        Microsoft Cognitive Toolkit (CNTK), an open source deep-learning toolkit
generator-jhipster:        JHipster is a development platform to quickly generate, develop, & deploy modern web applications & microservice architectures.
spring-boot-demo:        spring boot demo æ˜¯ä¸€ä¸ªç”¨æ¥æ·±åº¦å­¦ä¹ å¹¶å®æˆ˜ spring boot çš„é¡¹ç›®ï¼Œç›®å‰æ€»å…±åŒ…å« 65 ä¸ªé›†æˆdemoï¼Œå·²ç»å®Œæˆ 53 ä¸ªã€‚ è¯¥é¡¹ç›®å·²æˆåŠŸé›†æˆ actuator(ç›‘æ§)ã€admin(å¯è§†åŒ–ç›‘æ§)ã€logback(æ—¥å¿—)ã€aopLog(é€šè¿‡AOPè®°å½•webè¯·æ±‚æ—¥å¿—)ã€ç»Ÿä¸€å¼‚å¸¸å¤„ç†(jsonçº§åˆ«å’Œé¡µé¢çº§åˆ«)ã€freemarker(æ¨¡æ¿å¼•æ“)ã€thymeleaf(æ¨¡æ¿å¼•æ“)ã€Beetl(æ¨¡æ¿å¼•æ“)ã€Enjoy(æ¨¡æ¿å¼•æ“)ã€JdbcTemplate(é€šç”¨JDBCæ“ä½œæ•°æ®åº“)ã€JPA(å¼ºå¤§çš„ORMæ¡†æ¶)ã€mybatis(å¼ºå¤§çš„ORMæ¡†æ¶)ã€é€šç”¨Mapper(å¿«é€Ÿæ“ä½œMybatis)ã€PageHelper(é€šç”¨çš„Mybatisåˆ†é¡µæ’ä»¶)ã€mybatis-plus(å¿«é€Ÿæ“ä½œMâ€¦
IntelliJ-IDEA-Tutorial:        IntelliJ IDEA ç®€ä½“ä¸­æ–‡ä¸“é¢˜æ•™ç¨‹
toBeTopJavaer:        To Be Top Javaer - Javaå·¥ç¨‹å¸ˆæˆç¥ä¹‹è·¯
ExoPlayer:        An extensible media player for Android
jenkins:        Jenkins automation server
easyexcel:        å¿«é€Ÿã€ç®€å•é¿å…OOMçš„javaå¤„ç†Excelå·¥å…·
JavaFamily:        ã€Javaé¢è¯•+Javaå­¦ä¹ æŒ‡å—ã€‘ ä¸€ä»½æ¶µç›–å¤§éƒ¨åˆ†Javaç¨‹åºå‘˜æ‰€éœ€è¦æŒæ¡çš„æ ¸å¿ƒçŸ¥è¯†ã€‚
flatbuffers:        FlatBuffers: Memory Efficient Serialization Library
xxl-job:        A distributed task scheduling framework.ï¼ˆåˆ†å¸ƒå¼ä»»åŠ¡è°ƒåº¦å¹³å°XXL-JOBï¼‰
spring-cloud-alibaba:        Spring Cloud Alibaba provides a one-stop solution for application development for the distributed solutions of Alibaba middleware.
Android-CleanArchitecture:        This is a sample app that is part of a series of blog posts I have written about how to architect an android application using Uncle Bob's clean architecture approach.
dbeaver:        Free universal database tool and SQL client
mybatis-3:        MyBatis SQL mapper framework for Java
cat:        CAT ä½œä¸ºæœåŠ¡ç«¯é¡¹ç›®åŸºç¡€ç»„ä»¶ï¼Œæä¾›äº† Java, C/C++, Node.js, Python, Go ç­‰å¤šè¯­è¨€å®¢æˆ·ç«¯ï¼Œå·²ç»åœ¨ç¾å›¢ç‚¹è¯„çš„åŸºç¡€æ¶æ„ä¸­é—´ä»¶æ¡†æ¶ï¼ˆMVCæ¡†æ¶ï¼ŒRPCæ¡†æ¶ï¼Œæ•°æ®åº“æ¡†æ¶ï¼Œç¼“å­˜æ¡†æ¶ç­‰ï¼Œæ¶ˆæ¯é˜Ÿåˆ—ï¼Œé…ç½®ç³»ç»Ÿç­‰ï¼‰æ·±åº¦é›†æˆï¼Œä¸ºç¾å›¢ç‚¹è¯„å„ä¸šåŠ¡çº¿æä¾›ç³»ç»Ÿä¸°å¯Œçš„æ€§èƒ½æŒ‡æ ‡ã€å¥åº·çŠ¶å†µã€å®æ—¶å‘Šè­¦ç­‰ã€‚
redisson:        Redisson - Redis Java client with features of In-Memory Data Grid. Over 50 Redis based Java objects and services: Set, Multimap, SortedSet, Map, List, Queue, Deque, Semaphore, Lock, AtomicLong, Map Reduce, Publish / Subscribe, Bloom filter, Spring Cache, Tomcat, Scheduler, JCache API, Hibernate, MyBatis, RPC, local cache ...
hutool:        A set of tools that keep Java sweet.
flink:        Apache Flink
HikariCP:        å…‰ HikariCPãƒ»A solid, high-performance, JDBC connection pool at last.
java8-tutorial:        Modern Java - A Guide to Java 8
Sentinel:        A powerful flow control component enabling reliability, resilience and monitoring for microservices. (é¢å‘äº‘åŸç”Ÿå¾®æœåŠ¡çš„é«˜å¯ç”¨æµæ§é˜²æŠ¤ç»„ä»¶)
graal:        GraalVM: Run Programs Faster Anywhere ğŸš€
logger:        âœ”ï¸ Simple, pretty and powerful logger for android
ray:        A fast and simple framework for building and running distributed applications. Ray is packaged with RLlib, a scalable reinforcement learning library, and Tune, a scalable hyperparameter tuning library.
LearningNotes:        Enjoy Learning.
deeplearning4j:        Eclipse Deeplearning4j, ND4J, DataVec and more - deep learning & linear algebra for Java/Scala with GPUs + Spark
playframework:        Play Framework
logstash:        Logstash - transport and process your logs, events, or other data
bytecode-viewer:        A Java 8+ Jar & Android APK Reverse Engineering Suite (Decompiler, Editor, Debugger & More)
vert.x:        Vert.x is a tool-kit for building reactive applications on the JVM
MaterialDrawer:        The flexible, easy to use, all in one drawer library for your Android project. Now brand new with material 2 design.
infer:        A static analyzer for Java, C, C++, and Objective-C
androidannotations:        Fast Android Development. Easy maintainance.
realm-java:        Realm is a mobile database: a replacement for SQLite & ORMs
RxTool:        Androidå¼€å‘äººå‘˜ä¸å¾—ä¸æ”¶é›†çš„å·¥å…·ç±»é›†åˆ | æ”¯ä»˜å®æ”¯ä»˜ | å¾®ä¿¡æ”¯ä»˜ï¼ˆç»Ÿä¸€ä¸‹å•ï¼‰ | å¾®ä¿¡åˆ†äº« | Zip4jå‹ç¼©ï¼ˆæ”¯æŒåˆ†å·å‹ç¼©ä¸åŠ å¯†ï¼‰ | ä¸€é”®é›†æˆUCropé€‰æ‹©åœ†å½¢å¤´åƒ | ä¸€é”®é›†æˆäºŒç»´ç å’Œæ¡å½¢ç çš„æ‰«æä¸ç”Ÿæˆ | å¸¸ç”¨Dialog | WebViewçš„å°è£…å¯æ’­æ”¾è§†é¢‘ | ä»¿æ–—é±¼æ»‘åŠ¨éªŒè¯ç  | Toastå°è£… | éœ‡åŠ¨ | GPS | Locationå®šä½ | å›¾ç‰‡ç¼©æ”¾ | Exif å›¾ç‰‡æ·»åŠ åœ°ç†ä½ç½®ä¿¡æ¯ï¼ˆç»çº¬åº¦ï¼‰ | è››ç½‘ç­‰çº§ | é¢œè‰²é€‰æ‹©å™¨ | ArcGis | VTPK | ç¼–è¯‘è¿è¡Œä¸€ä¸‹è¯´ä¸å®šä¼šæ‰¾åˆ°æƒŠå–œ
presto:        The official home of the Presto distributed SQL query engine for big data
mockito:        Most popular Mocking framework for unit tests written in Java
technology-talk:        æ±‡æ€»javaç”Ÿæ€åœˆå¸¸ç”¨æŠ€æœ¯æ¡†æ¶ã€å¼€æºä¸­é—´ä»¶ï¼Œç³»ç»Ÿæ¶æ„ã€æ•°æ®åº“ã€å¤§å…¬å¸æ¶æ„æ¡ˆä¾‹ã€å¸¸ç”¨ä¸‰æ–¹ç±»åº“ã€é¡¹ç›®ç®¡ç†ã€çº¿ä¸Šé—®é¢˜æ’æŸ¥ã€ä¸ªäººæˆé•¿ã€æ€è€ƒç­‰çŸ¥è¯†
android-async-http:        This project under develop
tink:        Tink is a multi-language, cross-platform, open source library that provides cryptographic APIs that are secure, easy to use correctly, and hard(er) to misuse.
recyclerview-animators:        An Android Animation library which easily add itemanimator to RecyclerView items.
elasticsearch-analysis-ik:        The IK Analysis plugin integrates Lucene IK analyzer into elasticsearch, support customized dictionary.
PermissionsDispatcher:        A declarative and comprehensive API to handle Android runtime permissions.
Android:        GitHubä¸Šæœ€ç«çš„Androidå¼€æºé¡¹ç›®,æ‰€æœ‰å¼€æºé¡¹ç›®éƒ½æœ‰è¯¦ç»†èµ„æ–™å’Œé…å¥—è§†é¢‘
uCrop:        Image Cropping Library for Android
jib:        ğŸ— Build container images for your Java applications.
webmagic:        A scalable web crawler framework for Java.
labs:        This is a collection of tutorials for learning how to use Docker with various tools. Contributions welcome.
mybatis-plus:        An powerful enhanced toolkit of MyBatis for simplify development
spring-boot-admin:        Admin UI for administration of spring boot applications
glide-transformations:        An Android transformation library providing a variety of image transformations for Glide.
fullstack-tutorial:        ğŸš€ fullstack tutorial 2020ï¼Œåå°æŠ€æœ¯æ ˆ/æ¶æ„å¸ˆä¹‹è·¯/å…¨æ ˆå¼€å‘ç¤¾åŒºï¼Œæ˜¥æ‹›/ç§‹æ‹›/æ ¡æ‹›/é¢è¯•
Sourcetrail:        Sourcetrail - free and open-source interactive source explorer
BottomBar:        (Deprecated) A custom view component that mimics the new Material Design Bottom Navigation pattern.
zookeeper:        Mirror of Apache Hadoop ZooKeeper
MaterialViewPager:        A Material Design ViewPager easy to use library
antlr4:        ANTLR (ANother Tool for Language Recognition) is a powerful parser generator for reading, processing, executing, or translating structured text or binary files.
ip2region:        Ip2region is a offline IP location library with accuracy rate of 99.9% and 0.0x millseconds searching performance. DB file is ONLY a few megabytes with all IP address stored. binding for Java,PHP,C,Python,Nodejs,Golang,C#,lua. Binary,B-tree,Memory searching algorithm
jsoup:        jsoup: Java HTML Parser, with best of DOM, CSS, and jquery
spring-boot-api-project-seed:        ğŸŒ±ğŸš€ä¸€ä¸ªåŸºäºSpring Boot & MyBatisçš„ç§å­é¡¹ç›®ï¼Œç”¨äºå¿«é€Ÿæ„å»ºä¸­å°å‹APIã€RESTful APIé¡¹ç›®~
cas:        Apereo CAS - Enterprise Single Sign On for all earthlings and beyond.
dropwizard:        A damn simple library for building production-ready RESTful web services.
finagle:        A fault tolerant, protocol-agnostic RPC system